1111111111111111111111111111111
1111111111111111111111111111111
1010199999001000000000000000001
1010191119111111101111111010111
9999990019001010001010101010001
1010101119111011101010101110101
1010101009999900100000000010101
1111111110101911111011101111101
1010101010101900100010001010001
1010101011111911101011101011101
1000000000100900101010000010101
1011101111111911111111111010111
1000101010099900101010100000101
1011111011191011101010111110101
1010100999991019999999001000001
1010111910101119111019111111101
1999999910101999001019990010001
1910101011111911111110191111101
1910101010199900100010190010001
1911111110191111111011191111101
1999001000090010101010090010101
1019111011191110101011191110101
1019001010190010000010090010001
1119111110191110111111191110111
1009990019990010101009990010001
1110191119111110101119101110111
1010199999001000001009101999991
1011101010111011101119111911099
1000001010100010000009999900101
1111111111111111111111111111111
1111111111111111111111111111111
