11111111111111111111111111111111111
11111111111111111111111111111111111
00001000000000100000000000000000101
10111111101110111010101110111011101
10001010001000000010101010001000101
10111011101110101011111010111011101
10000000100010101000100000001000001
10101011101111111111111011111010111
10101000100010001010101000101010001
11111011101110111010101011101110100
10100000100000101000000000101000001
10111011101111101011101011101110111
10100000100010100000101010001000001
10111011111110101111111110111110111
10100000001000000010100000101000001
10111010111110111110101111101110111
10001010001010001000000010000000001
10111110111010111011101111101010111
10001000001000001000101000001010101
10111110111011111011101110101111101
10001000000000100010101000101010001
10111110101011111010111110111010111
10000010101010000000100000001000101
10111111111111101110111010111110101
10101010000010001000000010100000001
10101010111011101110101011101111101
10000000101010000010101010001010101
11101110101111101111111110111010101
10001000001010000000100000101000001
10101111101011101011111111101011101
10101010000010101000001010100000101
10111011111010111010111010101111101
10000000100000000010000000000010001
11111111111111111111111111111111111
11111111111111111111111111111111111
